wwwwwwwwwwwwwwwwwwwwwwwwwwwwwwwwwwwwwwwwwwwwwwwwwwwwww
w                         w                          w
w         w               w                w         w
w         w                                w         w
w         w       wwwwwwww wwwwwwww        w         w
w      wwww       w               w        wwww      w
w                 w               w                  w
w                 w               w                  w
wwwww                                            wwwww
w                 w               w                  w
w                 w               w                  w
w      wwww       w               w        wwww      w
w         w       wwwwwwww wwwwwwww           w      w
w         w                                   w      w
w         w               w                   w      w
w                         w                          w
wwwwwwwwwwwwwwwwwwwwwwwwwwwwwwwwwwwwwwwwwwwwwwwwwwwwww